NO textures/mc/mc_stone.xpm
SO textures/mc/mc_obsidian.xpm
WE textures/mc/mc_wood.xpm
EA textures/mc/mc_ground.xpm

F 164,169,20
C 153,204,255


1111111111111111111111
1000000000000000000001
1010101010101010101011
1000000000000000000001
1101010101010101010101
1000000000000000000001
1010101010101010101011
1000000000000000000001
1101010101010101010101
1000000000000000000001
1010101010101010101011
1000000000000000000001
1101010101010101010101
1000000000000000000001
1010101010101010101011
1000000000000000000001
1101010101010101010101
1000000000000000000001
10101010101N1010101011
1111111111111111111111
