NO textures/test/north.xpm
SO textures/test/south.xpm
WE textures/test/west.xpm
EA textures/test/east.xpm

F 164,169,20
C 153,204,255
1111111
1000001
1000001
1000001
1000001
1110111
1000001
100N101
1111111