NO textures/test/north.xpm
SO textures/test/south.xpm
WE textures/test/west.xpm
EA textures/test/east.xpm

F 164,169,20
C 153,204,255

111111111111111111111
10E001000000000000001
111011111111111111011
100010100010000010001
111110101111101011101
100000101000101000001
101111101011101111111
101000001010100000101
101011111010111110101
101010001010100010101
101110101010101010101
100000101010001010001
111111101001111011101
100000101000100010001
101110101110101110111
101000100000100010101
101011111111111010101
100010000000000010001
100010000000000010001
101000000000000000001
111111111111111111111

