NO textures/test/north.xpm
SO textures/test/south.xpm
WE textures/test/west.xpm
EA textures/test/east.xpm

C 252,177,3
F 252,194,3

111111111111111111111
10E000000000000000001
110000100000001111111
100000100000001010001
111110101111101011101
100000101000101000001
101111101011101111111
101000001010100000101
101011111010111110101
101010001010100010101
101110101010101010101
100000101010001010001
111111101001111011101
100000101000100010001
101110101110101110111
101000100000100010101
101011111111111010101
100010000000000010001
100010000000000010001
101000000000000000001
111111111111111111111

