NO textures/test/north.xpm
SO textures/test/south.xpm
WE textures/test/west.xpm
EA textures/test/east.xpm

F 164,169,20
C 153,204,255


11111
10001
10N01
10001
11111

