NO textures/mc/mc_stone.xpm
SO textures/mc/mc_obsidian.xpm
WE textures/mc/mc_wood.xpm
EA textures/mc/mc_ground.xpm

F 164,169,20
C 153,204,255


1111111111111111111111
1000000000000000000001
1000000000000000000001
1000000000000000000001
1000000000000000000001
1000000000000000000001
1000000000000000000001
1000000000000000000001
1000000000000000000001
1000000000000000000001
1000000000000000000001
1000000000000000000001
1000000000000000000001
1000000000000000000001
1000000000000000000001
1000000000N00000000001
1111111111111111111111
