NO textures/hw/hw_north.xpm
SO textures/hw/hw_south.xpm
WE textures/hw/hw_west.xpm
EA textures/hw/hw_east.xpm

F 0,0,0
C 38, 38, 38

111111111111111111
101000000100010001
100000100000000101
101000000001000001
100001111111100001
100001      100001
100001      100001
100001      100001
100001111111100001
100000000000000001
111111000000011111
101010001001000001
100000000110000001
1N0000000100000001
111111111111111111
