NO textures/hw/hw_north.xpm
SO textures/hw/hw_south.xpm
WE textures/hw/hw_west.xpm
EA textures/hw/hw_east.xpm

F 15,15, 15
C 29, 29, 29

111111111111111111111111111
100000000000000000000000001
100000000000000000000000001
100111110000000000001111101
101     100000000001    101
101       10000001      101
100111100000000000001111001
100000000000000000000000001
1001100N0111000011100011101
111  1111   11111  111  111
1111                   1111
111111  111  11111   111111
111111111111111111111111111
