SO textures/test/w_south.xpm
WE textures/test/w_west.xpm
NO textures/test/w_north.xpm
EA textures/test/w_est.xpm

F 164,169,20
C 153,204,255

111111111111111111
100000000000000001
100000110000000001
101000110100000001
100000110000000001
101000110100011111
10000011000001
11110011111001
10010000001001
10000011000001
10000011000001
1000W011000001
10111111111101
101        101
101        101
101        101        
10111111111101
10000000100001
10000000000001
11111111111111
