SO textures/tex_1/w_south.xpm
WE textures/tex_1/w_west.xpm
NO textures/tex_1/w_north.xpm
EA textures/tex_1/w_east.xpm

F 164,169,20
C 153,204,255

111111111111111
11111000001111
11111000011111
11100000111111
100001111111
1E00011111
1111111111
