SO textures/wolfenstein/blue_stone.xpm
WE textures/wolfenstein/color_stone.xpm
NO textures/wolfenstein/eagle.xpm
EA textures/wolfenstein/grey_stone.xpm

F 164,169,20
C 153,204,255

111111111111
100000000001
100000000001
100000000001
100000000001
100010100001
100011100001
100000000001
100000000001
1000000N0001
111111111111
