SO textures/tex_1/w_south.xpm
WE textures/tex_1/w_west.xpm
NO textures/tex_1/w_north.xpm
EA textures/tex_1/w_east.xpm

F 164,169,20
C 153,204,255

111111111111
100000000001
100000000001
100000000001
100000000001
100000000001
100000000001
100000000001
100000000001
100000000001
100000000001
1000000N0001
111111111111
