SO textures/tex_1/w_south.xpm
WE textures/tex_1/w_west.xpm
NO textures/tex_1/w_north.xpm
EA textures/tex_1/w_east.xpm

F 164,169,20
C 153,204,255

        1111111111111111111111111
        1000000000110000000100001
        1011000001110000001000001
        1001000000000000100000001
111111111011000001110010000000001
100000000011000001110111111111111
11110111111111011100000010001
11110111111111011100000010001
11110111111111011100000010001
11110111111111011100000010001
11110111111111011100000010001
11110111111111011100000010001
11110111111111011100000010001
11110111111111011100000010001
11110111111111011100000010001
11110111111111011101010010001
11000000110101011100000010001
10000000000000001100000010001
10000000000000001101010N10001
11000001110101011111011110001
11110111111101010101111010001
11111111111111111111111111111
