SO textures/tex_1/w_south.xpm
WE textures/tex_1/w_west.xpm
NO textures/tex_1/w_north.xpm
EA textures/tex_1/w_east.xpm

F 164,169,20
C 153,204,255

1111111
1000001
1000001
1000001
1N00001
1111111